-- 索引の対象語彙

-- A
関係 : かんけい
甲州記法 : こうしゅうきほう
甲州計算機 : こうしゅうけいさんき

-- B
項目 : こうもく
項目内容 : こうもくないよう
項目名 : こうもくめい
判断 : はんだん

-- C
集合 : しゅうごう

-- D

-- E
真 : しん
偽 : ぎ
組 : くみ

-- F
データ解釈 : でーたかいしゃく
肯定判断 : こうていはんだん
述語 : じゅつご
判断種 : はんだんしゅ
否定判断 : ひていはんだん

-- G
コッド : こっど
フレーゲ : ふれーげ
関係モデル : かんけいもでる
関係写像 : かんけいしゃぞう
内容線 : ないようせん
判断線 : はんだんせん

-- H

-- I

-- J

-- K
パターン : ぱたーん

-- L
交わり : まじわり
共有項目 : きょうゆうこうもく
可換性 : かかんせい
べき等性 : べきとうせい

-- M
共通部分 : きょうつうぶぶん
直積 : ちょくせき
デカルト積 : でかるとせき
固有項目 : こゆうこうもく
連立方程式 : れんりつほうていしき

-- N
結び : むすび
データ構造依存性 : でーたこうぞういぞんせい
データベース : でーたべーす
代数系 : だいすうけい
トロパシコ : とろぱしこ
関係束 : かんけいそく

-- O
空集合 : くうしゅうごう
空関係 : くうかんけい
無項関係 : むこうかんけい

-- P
見出し : みだし
本体 : ほんたい
万有関係 : ばんゆうかんけい
全項関係 : ぜんこうかんけい

-- Q

-- R
たぶん : たぶん
空番 : くうばん
全称否定 : ぜんしょうひてい

-- S
交わり部分関係 : まじわりぶぶんかんけい
入れ子の関係 : いれこのかんけい
自然言語 : しぜんげんご
論理学 : ろんりがく
数学 : すうがく

-- T
項目内容リスト : こうもくないようりすと
リスト : りすと

-- U

-- V
所属関係 : しょぞくかんけい

-- W
Haskell : Haskell

-- X
関数 : かんすう
入出力関係 : にゅうしゅつりょくかんけい

